%%%%%%%%%%%%%%%%%%%%%%%%%%%%%%%%%%%%
% .                               P%
% %%%%%%%%%%%%%%%%%%%%%%% %%%%%%%% %
% %%   %   %      %%%%%%%   %%     %
% %% % % % % %%%% %%%%%%%%% %% %%%%%
% %% % % % %             %% %%     %
% %% % % % % % %%%%  %%%    %%%%%% %
% %  % % %   %    %% %%%%%%%%      % 
% %% % % %%%%%%%% %%        %% %%%%%
% %% %   %%       %%%%%%%%% %%     %
%.   %%%%%% %%%%%%%      %% %%%%%% %
%%%%%%      %       %%%% %% %      %
%      %%%%%% %%%%% %    %% %% %%%%%
% %%%%%%      %       %%%%% %%     %
%        %%%%%% %%%%%%%%%%% %%  %% %
%%%%%%%%%%                  %%%%%% %
%.         %%%%%%%%%%%%%%%%       .%
%%%%%%%%%%%%%%%%%%%%%%%%%%%%%%%%%%%%